#######################
#.....................#
#.###..##########.###.#
#.#....##.........#...#
#.#....##..G......###.#
#.#....##.GGG.......#.#
#.###..#########..###.#
.......................
#.###..##########.###.#
#.#....##.........#...#
#.#....##.........###.#
#.#....##########...#.#
#.###......P...##.###.#
#......##########.....#
#.....................#
#######################