#######################
.......................
#.#.#..##########...###
#.#.......# #.........#
#.#.#....#...#......###
#.#.....#.....#.......#
#.#.#..#.......#....###
.......................
#.#.#..##########...###
#.#.......# #.........#
#.#.#....#...#......###
#.#.....#.....#.......#
#.#.#..#...P...#....###
.......................
#.#.#..##########...###
#.#....#.......... ...#
#.#.#..#......... ..###
#.#....#......... ....#
#.#.#..##########...###
.......................
#######################